32 26
c e b b b b b b b j a a a b b b b b b j a a a b b b b b b b c e
d f l g g g g g g k a a a i g g g g g k a a a i g g g g g g d f
c e h a a a a a a a a a a a a a a a a a a a a a a a a a a a c e
d f h a a a a a a a a a a a a a a a a a a a a a a a a a a a d f
c e h a a a a a a a a a a a a a a a a a a a a a a a a a a a c e
d f h a a a b b b b b b b b b b b b b b b b b b b b b b b b d f
c e h a a a i g g g g g g g g g g g g g g g g g g g g g g g c e
d f h a a a a a a a a a a a a a a a a a a a a a a a a a a a d f
c e h a a a a a a a a a a a a a a a a a a a a a a a a a a a c e
d f h a a a a a a a a a a a a a a a a a a a a a a a a a a a d f
c e b b b b b b b b b b b b b b b b b b b b b b b b j a a a c e
d f l g g g g g g g g g g g g g g g g g g g g g g g k a a a d f
c e h a a a a a a a a a a a a a a a a a a a a a a a a a a a c e
d f h a a a a a a a a a a a a a a a a a a a a a a a a a a a d f
c e h a a a a a a a a a a a a a a a a a a a a a a a a a a a c e
d f h a a a b b b b b b b b b b b b b b b b b b b b b b b b d f
c e h a a a i g g g g g g g g g g g g g g g g g g g g g g g c e
d f h a a a a a a a a a a a a a a a a a a a a a a a a a a a d f
c e h a a a a a a a a a a a a a a a a a a a a a a a a a a a c e
d f h a a a a a a a a a a a a a a a a a a a a a a a a a a a d f
c e h a b b b b b b b b b b a j a b b b b b b b b b b a j a c e
d f h a i g g g g g g g g g a k a i g g g g g g g g g a k a d f
c e h a a a a a a a a a a a a a a a a a a a a a a a a a a a c e
d f h a a a a a a a a a a a a a a a a a a a a a a a a a a a d f
c e h a a a a a a a a a a a a a a a a a a a a a a a a a a a c e
d f b b b b b b b j a a a b b b b b b j a a a b b b b b b b d f
