16	18	1	1	1	1	1	1	1	233	0	0	0	1	1	1	1	1	1	233	0	0	0	1	1	1	1	1	1	1	16	18
17	19	1	1	1	1	1	1	1	233	0	0	0	1	1	1	1	1	1	233	0	0	0	1	1	1	1	1	1	1	17	19
16	18	1	1	1	1	1	1	1	233	0	0	0	1	1	1	1	1	1	233	0	0	0	1	1	1	1	1	1	1	16	18
17	19	1	1	1	1	1	1	1	233	0	0	0	1	1	1	1	1	1	233	0	0	0	1	1	1	1	1	1	1	17	19
16	18	1	1	1	1	1	1	1	233	0	0	0	1	1	1	1	1	1	233	0	0	0	1	1	1	1	1	1	1	16	18
17	19	237	232	232	232	232	232	232	236	0	0	0	234	232	232	232	232	232	236	0	0	0	234	232	232	232	232	232	232	17	19
16	18	233	0	0	0	0	0	0	0	0	0	0	0	0	0	0	0	0	0	0	0	0	0	0	0	0	0	0	0	16	18
17	19	233	0	0	0	0	0	0	0	0	0	0	0	0	0	0	0	0	0	0	0	0	0	0	0	0	0	0	0	17	19
16	18	233	0	0	0	0	0	0	0	0	0	0	0	0	0	0	0	0	0	0	0	0	0	0	0	0	0	0	0	16	18
17	19	233	0	0	0	1	1	1	1	1	1	1	1	1	1	1	1	1	1	1	1	1	1	1	1	1	1	1	1	17	19
16	18	233	0	0	0	234	232	232	232	232	232	232	232	232	232	232	232	232	232	232	232	232	232	232	232	232	232	232	232	16	18
17	19	233	0	0	0	0	0	0	0	0	0	0	0	0	0	0	0	0	0	0	0	0	0	0	0	0	0	0	0	17	19
16	18	233	0	0	0	0	0	0	0	0	0	0	0	0	0	0	0	0	0	0	0	0	0	0	0	0	0	0	0	16	18
17	19	233	0	0	0	0	0	0	0	0	0	0	0	0	0	0	0	0	0	0	0	0	0	0	0	0	0	0	0	17	19
16	18	1	1	1	1	1	1	1	1	1	1	1	1	1	1	1	1	1	1	1	1	1	1	1	1	235	0	0	0	16	18
17	19	237	232	232	232	232	232	232	232	232	232	232	232	232	232	232	232	232	232	232	232	232	232	232	232	236	0	0	0	17	19
16	18	233	0	0	0	0	0	0	0	0	0	0	0	0	0	0	0	0	0	0	0	0	0	0	0	0	0	0	0	16	18
17	19	233	0	0	0	0	0	0	0	0	0	0	0	0	0	0	0	0	0	0	0	0	0	0	0	0	0	0	0	17	19
16	18	233	0	0	0	0	0	0	0	0	0	0	0	0	0	0	0	0	0	0	0	0	0	0	0	0	0	0	0	16	18
17	19	233	0	0	0	1	1	1	1	1	1	1	1	1	1	1	1	1	1	1	1	1	1	1	1	1	1	1	1	17	19
16	18	233	0	0	0	234	232	232	232	232	232	232	232	232	232	232	232	232	232	232	232	232	232	232	232	232	232	232	232	16	18
17	19	233	0	0	0	0	0	0	0	0	0	0	0	0	0	0	0	0	0	0	0	0	0	0	0	0	0	0	0	17	19
16	18	233	0	0	0	0	0	0	0	0	0	0	0	0	0	0	0	0	0	0	0	0	0	0	0	0	0	0	0	16	18
17	19	233	0	0	0	0	0	0	0	0	0	0	0	0	0	0	0	0	0	0	0	0	0	0	0	0	0	0	0	17	19
16	18	233	0	1	1	1	1	1	1	1	1	1	1	235	0	0	1	1	1	1	1	1	1	1	1	1	235	0	0	16	18
17	19	233	0	234	232	232	232	232	232	232	232	232	232	236	0	0	234	232	232	232	232	232	232	232	232	232	236	0	0	17	19
16	18	233	0	0	0	0	0	0	0	0	0	0	0	0	0	0	0	0	0	0	0	0	0	0	0	0	0	0	0	16	18
17	19	233	0	0	0	0	0	0	0	0	0	0	0	0	0	0	0	0	0	0	0	0	0	0	0	0	0	0	0	17	19
16	18	233	0	0	0	0	0	0	0	0	0	0	0	0	0	0	0	0	0	0	0	0	0	0	0	0	0	0	0	16	18
17	19	1	1	1	1	1	1	1	233	0	0	0	1	1	1	1	1	1	233	0	0	0	1	1	1	1	1	1	1	17	19
16	18	1	1	1	1	1	1	1	233	0	0	0	1	1	1	1	1	1	233	0	0	0	1	1	1	1	1	1	1	16	18
17	19	1	1	1	1	1	1	1	233	0	0	0	1	1	1	1	1	1	233	0	0	0	1	1	1	1	1	1	1	17	19